R 1000 800
NO ./Ressource/textures/north.xpm
SO ./Ressource/textures/south.xpm
WE ./Ressource/textures/west.xpm
EA ./Ressource/textures/east.xpm
S ./Ressource/sprites/candlebra.xpm
C 150,75,0
F 200,200,200
11111111111111
10000000001001
10001000001001
10S01011000001
10001000000101
11111111111101
11111111111101
11111111111101
10000010000101
10100010010001
10111110011011
10000000000001
11111111111111
