R 1300 700
NO ./texture/north.png
SO ./texture/south.png
WE ./texture/west.png
EA ./texture/east.png
S ./texture/sprite.png
C 0,0,200
F 128,128,128
1111111111111111111111111
1000000000000111111111111
1000000000000111111111111
1000111110000111111111111
1000000010000000000000001
100N000000000111111111001
1000000000000111111111001
1111111111111111111111111
