R 1000 700
NO ./Ressource/textures/north.xpm
SO ./Ressource/textures/south.xpm
WE ./Ressource/textures/west.xpm
EA ./Ressource/textures/east.xpm
S ./Ressource/sprites/candlebra.xpm
SK ./Ressource/textures/Background.xpm
C 150,75,0
F 30,30,30
11111111111111
10000000001001
10001002001001
10N01011000001
10001000000101
11111111111101
11111111111101
11111111111101
10000010000101
10100010010001
10111110011011
10000000000001
11111111111111
