R 1920 1080
NO ./texture/north.png
SO ./texture/south.png
WE ./texture/west.png
EA ./texture/east.png
S ./texture/sprite.png
F 220,100,0
C 225,30,0
11111111
11002001
10000001
11111111
