R 1920 1080
NO ./texture/north.png
SO ./texture/south.png
WE ./texture/west.png
EA ./texture/east.png
F 220,100,0
C 225,30,0
1r111111111111111111111111111111111111111111111111111111111111
10000000000000000000000000110000000000000000000000000000000001
10000000000000000000000000110000S00000000000000000000000000001
10000020000000000000000000110000000000000000000000000000000001
10000000000000000000000000110000000000000000000000000000000001
10000000000000000000000000110000000000000000000000000000000001
10000000000000000000000000110000000000000000000000000000000001
10000000000000000000000000110000000000000000000000000000000001
10000000000000000000000000110000000000000000000000000000000001
10000000000000000000000000110000000000000000000000000000000001
11111111111111111000111111111111111111111001111111111111111111
10000000000000000000000000000000000000000000000000000000000001
10000000000000000000000000000000000000000000000000000000000001
10000000000000000000000000000000000000000000000000000000000001
10000000000000000000000000000000000000000000000000000000000001
10000000002000000000000000000000000000000000000000000000000001
10000000000000000000000000000000000000000000000000000000000001
10000000000000000000000000000000000000000000000000000000000001
10000000000000000000000000000000000000000000000000000000000001
10000000000000000000000000000000000000000000000000000000000001
10000000000000000000000000000000000000000000000000000000000001
10000000000000000000000000000000000000000000000000000000000001
11111111111111111111111111111111111111111111111111111111000111
10000000000000000000000000000000000000000000000000000001000111
10000000000000000000000000000000000000000000000000000001000111
10000000000000000000000000000000000000000000000000000001000111
10000000000000000000000000000000000000000000000000000001000111
10000000000000000000000000000000000000000000000000000001000111
10000000000000000000000000000000000000000000000000000001000111
10000000000000000000000000000000000000000000000000000001000111
10000000000000000000000000000000000000000000000000000011001111
10000000000000000000000000000000200000000000000000000010001111
10000000000000000000000000000000000000000000000000000110011111
10000000000000000000000000000000000000000000000000000000011111
10000000000000000011111111111111111111111111111100000000011111
10000000000000000011111111111111111111111111111100000000000001
10000000000000000000000000000000000000000000000000000000000001
10000000000000000000000000000000000000000000000000000000000001
10000000000000000000000000000000000000000000000000000000000001
11111111111111111111111111111111111111111111111111111111111111
